#  #  #  #  #  #  #  #  #  #  E  #
#  .  .G  .  .  .  .  .  .  .  .  #
#  .  .  .  .  .  .  .  .  .  .  #
#  .  .  .  .  .  .  .  .  .  .  #
#  .  . #  #  #  #  #  #  #  #  #
#  .  .  .  .  .  .  .  .  .  .  #
#  .  .  .  .  .  .  .  .  .  .  #
#  ~  ~  ~  ~  ~  #  #  #  .  .  #
#  .  .  .y .  .  .  .  .$ .  .  #
#  .@ .  .y .  .  .  .  .  .  .  #
#  #  #  #  #  #  #  #  #  #  #  #