#  #  #  #  #  #  #  #  #  #  #  #
#  .$ .$ .$ #  .  .  .  .  .$ ~  #
#  .$ .$ .$ #  .  #  #  #  #  #  #
#  .$ .$ .$ #  .  .  .  .$ #  .  E
#  .  #  #  #  #  #  .G #  #  .  #
#  .  #  .  .  .  .  .  #  #  .  #
#  .  #  .  .  .  .  .  #  .  .  #
#  .  #  .  .G .  ~  .  #  .  .  #
#  .  .  .  .  .  ~  .  #  .  ~  #
#  .  .  .  .  .  .y .  .  .  ~  #
#  ~  ~  .  .@ .  ~  ~  ~  ~  ~  #
#  #  #  #  #  #  #  #  #  #  #  #
G[(7,4), (7,5), (7,6), (7,5), (7,4), (7,3)]
G[(4,7), (5,7), (4,7), (3,7)]