#  #  #  #  #  #  #  #  #  #  E  #
#  .  .  .  .  .  #  .  #  #  .  #
#  .  .  .  #  .  #  .  .  .  .  #
#  .  .  .  #  .  .  .  #  #  #  #
#  #  .  #  #  #  #  #  #  #  #  #
#  .  .  .  .  ~  .  .  .  .  .  #
#  .  .  .  .  ~  .  .  .  .  .  #
#  ~  ~  ~  ~  ~  #  #  #  .  .  #
#  ~  ~  ~  ~  ~  #  #  #  .  .  #
#  .  .  .y .  .  .  .  .  .  .  #
#  .@ .  .y .  .  .  .  .  .  .  #
#  #  #  #  #  #  #  #  #  #  #  #