#  #  #  #  #  #  #  #  #  #  .  #
#  .  .  .  .  .  #  .  #  #  .  #
#  .  .  .  #  .  #  .  .  .  .  #
#  .  .  .  #  .  .  .  #  #  #  #
#  #  .  #  #  #  #  #  #  #  #  #
#  .  .  .  .  ~  .  .  .  .  .  #
#  .  .  .  .  ~  .  .  .  .  .  #
#  ~  ~  ~  ~  ~  #  #y #  .  .  #
#  ~  ~  ~  ~  ~  #  #y #  .  .  #
#  .  .  .y .  .  .  .  .  .  .  #
#  .@ .  .y .  .  .  .  .  .  .  #
#  #  #  #  #  #  #  #  #  #  #  #