#  #  #  #  #  #  #  #  #  #  #  #  #  #  #  #  #  #  #
#  #  #  #  #  #  #  #  #  #  #  #  #  #  #  #  #  #  #
#  #  #  #  #  #  #  #  #  #  #  #  #  #  #  #  #  #  #
#  #  #  #  #  #  #  #  #  #  #  #  #  #  #  #  #  #  # 
#  #  #  #  #  #  #  #  #  #  #  #  #  #  #  #  #  #  #
#  ~  .  .  .  .  .  .  .  .  .  .  .  .  .  .  .G E  #
#  #  #  #  #  #  #  .@ #  #  #  #  #  #  #  #  #  #  #
#  #  #  #  #  #  #  #  #  #  #  #  #  #  #  #  #  #  #
#  #  #  #  #  #  #  #  #  #  #  #  #  #  #  #  #  #  #
#  #  #  #  #  #  #  #  #  #  #  #  #  #  #  #  #  #  #
#  #  #  #  #  #  #  #  #  #  #  #  #  #  #  #  #  #  #
#  #  #  #  #  #  #  #  #  #  #  #  #  #  #  #  #  #  #
#  #  #  #  #  #  #  #  #  #  #  #  #  #  #  #  #  #  #
#  #  #  #  #  #  #  #  #  #  #  #  #  #  #  #  #  #  #
#  #  #  #  #  #  #  #  #  #  #  #  #  #  #  #  #  #  #
#  #  #  #  #  #  #  #  #  #  #  #  #  #  #  #  #  #  #
G[(10, 5), (9, 5), (8, 5), (7, 5), (7, 6), (7, 5), (6, 5), (5, 5), (4, 5), (3, 5), (2, 5)]