#  #  X  #p #p #p #  #  #  #  #  #
#  #  .  #  #  B  .  ~  ~  ~  ~  #
#  #  .  #  #  .  .  .  ~  .  #  #
#  #  .  .  .  .  .  .  .  .  .  #
#  #  #  #  #  .  ~  ~  ~  .  .  #
#  .$ .  .  .  .  .  .  .  .  .  #
#  .  .  .  .  .  .  #  #  .  #  #
#  #  #  #  #  .  .  #  .$ .$ .$ #
#  .  .  .  .  .  .  #  .$ .$ .$ #
#  .@ .  .  .  .  .  #  .$ .$ .$ #
#  #  #  #  #  #  #  #  #  #  #  #
