#  #  #  #  #  #  #  #  #  #  E  #
#  .  .  .  .  .  #  .  #  #  .  #
#  .  .  .  #  .  #  .  .  .  .  #
#  .  .  .  #  .  .  .  #  #  #  #
#  #  .  #  #  #  #  #  #  #  #  #
#  .  .  .  .  ~  .  .  .  .  .  #
#  .  .  .  .  ~  .  .  .  .  .  #
#  ~  ~  ~  ~  ~  #y #  #  .  .  #
#  ~  ~  ~  ~  ~  #  #  #  .  .  #
#  .  .  .y .  .  .  .  .$ .  .  #
#  .@ .  .y .  .  .  .  .  .  .  #
#  #  #  #  #  #  #  #  #  #  #  #